 * * ******
 *        *
 * * *** **
 * *****  *
   *   *  *
** * *  * *
 * * * *  /
     * * **
****  *  **
     **   *
***********