 *    * * *
 *  *    
 *  *  * * *
 *  * * * * *
   *    *
* *  *  *  
 *  *  *  *
     * / *