 *  * * *         *
       *  * *  *  *
    * *   * * *    *
* *   *  *  * * *  *  *
* *  * *     *     *
/  *  * *   * *   *  *
     * *  *      *
* * *  * *   *  *  *  
  *   *  * * *    * 
 * *   *  *  *   *  
 * *  * *        * 
 *    *  *  *   *  
   *  * * *  *    * 
 * * *      * *  *  
      * *   *    
