 *   ***
 * *    
 * * ***
 * *****
   *   *
** * *  
 * * * *
     */*